10 10
0000000000
0        0
0333333330
0444444440
0555  5550
0555  5550
0444444440
0333333330
0        0
0000000000
          
          
 ++++++++ 
 @@@@@@@@ 
 ***  *** 
 ***  *** 
 @@@@@@@@ 
 ++++++++ 
          
          