23 43
0000000000000000000000000000000000000000000
0               1          1              0
0              1 1        1 1             0
0             1   1      1   1            0
0              5 5555555555 5             0
0             5             5             0
0           5  808       808  5           0
0          5        33         5          0
0         5   888888888888888   5         0
0       5   8                 8   5       0
0      5   8   77   77   77    8   5      0
0     5   8                     8   5     0
0    5   8   77   77   77   77   8   5    0
0   5   8                         8   5   0
0   5  8                           8  5   0
0   5  8                           8  5   0
0    5 8                           8 5    0
0     58                           85     0
0      5 8                       8 5      0
0      5  8                     8  5      0
0        5 8        8 8        8 5        0
0           555555555 555555555           0
0000000000000000000000000000000000000000000
                                           
                +          +               
               + +        + +              
              +   +      +   +             
               * ********** *              
              *             *              
            *  @ @       @ @  *            
           *        33         *           
          *   @@@@@@@@@@@@@@@   *          
        *   @                 @   *        
       *   @   ++   ++   ++    @   *       
      *   @                     @   *      
     *   @   ++   ++   ++   ++   @   *     
    *   @                         @   *    
    *  @                           @  *    
    *  @                           @  *    
     * @                           @ *     
      *@                           @*      
       * @                       @ *       
       *  @                     @  *       
         * @        @ @        @ *         
            ********* *********            
                                           